5 5 5 5 5 5 5 5 5 5 5 6 6 6 6 5 5 5 5 5 5 5 5 5 5 5 5 5 5 5 5 5 5 5 5
5 5 5 0 0 0 0 0 0 5 5 6 6 6 6 6 5 5 5 5 5 5 0 0 0 0 0 0 5 5 5 5 5 5 5
5 5 0 0 0 0 0 0 0 0 0 0 6 6 6 6 6 5 5 0 0 0 0 0 0 0 0 0 0 5 5 5 5 5 5
5 0 0 0 0 0 0 0 4 0 0 0 0 6 6 6 6 6 5 0 0 0 0 0 0 4 4 4 0 0 0 5 5 5 5
5 0 0 0 0 4 4 4 4 4 4 0 0 6 6 6 6 6 0 0 0 0 0 0 4 4 4 4 4 4 4 4 5 5 5
5 0 0 4 4 4 4 4 4 4 4 4 0 0 0 6 6 0 0 0 0 0 0 0 0 4 4 5 4 4 4 5 5 5 5
5 0 4 4 4 4 4 0 0 0 4 4 4 0 0 6 0 0 0 0 0 0 0 0 4 4 4 5 5 5 5 5 5 5 5
5 4 4 4 4 4 0 2 3 0 0 4 4 4 0 0 0 0 0 0 0 0 0 0 4 4 5 5 5 5 5 4 4 5 5
5 0 4 0 0 0 2 8 9 3 0 0 4 4 4 0 0 0 0 0 0 0 0 0 0 4 4 4 5 5 4 4 4 4 5
5 0 0 0 0 2 8 1 1 9 3 0 0 4 0 0 0 0 0 0 0 0 0 0 0 0 0 4 4 4 4 4 0 0 5
5 0 0 0 2 8 1 1 1 1 9 3 0 0 0 6 6 0 0 0 0 0 0 0 0 0 0 0 0 4 0 0 0 0 5
5 0 0 0 0 1 1 1 1 1 1 0 0 0 0 6 6 6 0 0 0 0 0 0 0 0 0 0 0 0 0 0 5 5 5 
5 0 0 0 0 1 1 1 11 1 1 0 0 0 6 6 6 6 6 6 0 0 0 0 0 0 0 0 0 0 0 5 5 5 5
5 0 0 0 0 1 1 1 10 1 1 0 0 0 6 6 6 6 6 6 6 0 0 0 0 0 0 0 0 5 5 5 5 5 5
5 0 0 0 0 0 0 0 0 0 0 0 0 0 6 6 6 6 6 6 6 0 0 0 0 0 0 0 5 5 5 5 5 5 5
5 5 0 0 0 0 0 0 0 0 0 0 0 6 6 6 6 6 6 6 6 6 0 0 0 0 0 0 5 5 5 5 5 5 5
5 5 0 0 4 4 4 4 4 0 0 0 6 6 6 6 6 6 6 6 6 6 6 0 4 4 0 5 5 5 5 5 5 5 5
5 5 0 4 4 4 4 4 4 4 0 6 6 6 6 6 6 6 6 6 6 6 6 4 4 4 4 5 5 5 5 5 5 5 5
5 5 5 4 4 4 4 4 4 4 6 6 6 6 6 6 6 6 6 6 6 6 4 4 4 4 4 4 5 5 5 5 5 5 5
5 5 5 4 4 4 4 4 4 6 6 6 6 6 6 6 6 6 6 6 6 4 4 4 4 4 4 4 4 5 5 5 5 5 5
5 5 5 5 4 4 4 4 6 6 6 6 6 6 6 6 6 6 6 6 4 4 4 4 4 4 4 5 5 5 5 5 5 5 5
5 5 5 5 5 5 5 5 6 6 6 6 6 6 6 6 6 6 6 6 5 5 5 5 5 5 5 5 5 5 5 5 5 5 5