0 0 0 0 0 0 0 0 0 0 0 0 0 0 0 0
0 0 0 0 0 0 0 0 0 0 0 0 0 0 0 0
0 0 0 0 0 2 3 0 0 0 0 0 0 0 0 0
0 0 0 0 2 8 9 3 0 0 0 0 0 0 0 0
0 0 0 2 8 1 1 9 3 0 0 0 0 0 0 0
0 0 2 8 1 1 1 1 9 3 0 0 0 0 0 0
0 2 8 1 1 1 1 1 1 9 3 0 0 0 0 0
2 8 1 1 1 1 1 1 1 1 9 3 0 0 0 0 
0 1 1 1 1 1 1 1 1 1 1 0 0 0 0 0
0 1 1 1 1 1 1 1 1 1 1 0 0 0 0 0
0 1 1 1 1 1 1 1 1 1 1 0 0 0 0 0
0 1 1 1 1 1 1 1 1 1 1 0 0 0 0 0